.   .   .   .   .   .   F   .   .   .
.   *   *   .   F   .   *   .   G   .
.   *   *   .   F   .   .   .   .   .
F   F   F   .   .   .   .   .   .   .
.   .   F   .   *   .   .   .   *   .
.   .   .   .   .   .   *   .   .   .
S   .   .   F   F   .   .   F   F   .
.   .   .   .   .   .   .   .   *   .
F   .   *   .   .   F   F   .   .   .
.   .   .   .   .   .   .   .   .   .