.   .   .   .   .   .   F   .   .   .
.   *   *   .   F   .   *   .   G   .
.   *   *   .   F   .   .   .   .   .
F   F   F   .   .   .   .   .   .   .
.   .   F   .   *   .   .   .   *   .
.   .   .   .   .   .   *   .   .   .
.   .   .   F   F   .   .   F   F   .
.   .   .   .   .   .   .   .   *   .
F   .   *   .   .   F   F   .   .   .
S   .   .   .   .   .   .   .   .   .