.   .   .   .   .
.   .   .   .   .
.   *   .   .   .
.   .   .   .   .
S   F   .   *   G