.   *   .   G   *
.   F   .   *   .
.   F   .   .   .
.   F   *   F   .
S   .   .   *   .