.   *   .   G   *
.   F   .   *   .
.   .   .   .   .
.   R   *   F   .
S   .   .   *   .